R 1156 764
C 100,100,255
F 66,66,66
NO  /home/home/work/cub3d/my/textures/xpm/walls/64/colorstone.xpm
SO /home/home/work/cub3d/my/textures/xpm/walls/64/greystone.xpm
WE  /home/home/work/cub3d/my/textures/xpm/walls/64/mossy.xpm
EA  /home/home/work/cub3d/my/textures/xpm/walls/64/redbrick.xpm
S  /home/home/work/cub3d/my/textures/xpm/sprites/barrel.xpm



1111111111111111111111111111 1111111111111111
1000000000000000000000000000100002000200000001
1000000000000000000000000000100000000000000001
1000001111111111110000000000100000000000000021
11111111        100000000000000000N00100011111
     1111111     10000021000000000000000000011
     1000001     10000000000000000000000100011
     11201011111 10001111111100000000000111111
     1000020001 10001      100000000000111111
     1020002000111000111    11110000011111
     1002000000000000001    11111000111111
     1000020000000000001      111000111111
1111 1000000000120000201      11100011
1111 10000000201111111111     11100011
1000110000000021          11111110001111
1020111111011111          11111110001111
10001   10001             11000200000211
1101    10001             11201110001111
1000111110001             11221110001111
1020100210001             11221110001111
1000000010001             111111100011
1000100210001             1111111000111111111
1000111111011111                1000000000001   11111111111
1000112000000001          111111200021110110111112000000211
1000110000000001          120200000000000000000000020000011
1000110020000001         1200000000000000000000000002000011
1000010000000001          100000000000000000020000000000011
1000000200000001          120200000000220000000000020000011
1000010000000001          100000000000000000200000000000011
10001100200000011        1200000000000000000000000020000011
1000110200000001         1120000000000000000000200000000011
11111111111111111111111111111110000001111111111111111111111
11111111111111111111111111111110000001111111111111111111111
1000110000000201         111210100000110000000000200000001111111
1020112111011111            1 1100000000000011000110000120120101
1000011110001                  110000111111111100010001000000001
10001111000001                 1000001       1000110000000000001
1000120210001                  1100001       110201111111111111
1000002010201                  1000011       10001100100000101
10001200200001   1             1000001       11000100202220011
10201111100001111011111 1      1100011       11000002020002201
10200111002010100110120101     100001        10020100220020211
100000000000000001000002101    1100001       11011100101010101
1020002000200020000002000001   1000001       11111111111111111
100000000000000001000002101    1000011
100100100111110111101210111 111110000111111
1111111111010010010211111  1101010000111011
        1002001001001     10220010000000001
         101000001111   1100000000000020001
          1 10111     110000000000000000001
            1001      100000000000000000001
            1021      100000022000000000111
            1111      100000022000000000011
                      100000022000000000201
                      110000022000000000011
                      100000002000000000111
                      110000000000000000011
                      100000000000000000011
                      110000000000000000011
111111111111111111111111111111111111111111111111111111111111111111111
1