     NO      ./textures/xpm/walls/512/wall_green_tiles.xpm
 SO ./textures/xpm/walls/512/wall_small_tiles_texture.xpm
 WE ./textures/xpm/walls/512/wall_white_tiles_texture.xpm
EA ./textures/xpm/walls/512/old_wall_texture.xpm
S ./textures/xpm/sprites/ball.xpm


R       1536     864


F 0, 43, 23
C 00, 51, 102




     11111111111111111111111111111
         10000000001100000000001111
       11110110000011100000000111111
     11111001010000000100002000001 1
111111111011000001110000000000001111
11111111111111111111111111111111111111

