R  680 580
C  33,33,33
F  66,66,66
NO  /home/home/work/cub3d/my/textures/xpm/walls/64/colorstone.xpm
SO  /home/home/work/cub3d/my/textures/xpm/walls/64/greystone.xpm
WE  /home/home/work/cub3d/my/textures/xpm/walls/64/mossy.xpm
EA  /home/home/work/cub3d/my/textures/xpm/walls/64/redbrick.xpm
S  /home/home/work/cub3d/my/textures/xpm/sprites/r2d2.xpm

1111111111111111111111111111 11111111111111
1000000000000000000000000000111111111111111
100000000000000000000000000010000000000111111
1000001111111111110000N00000100000200000111111
11111122221      10000000000000000000000100011
     1222201     10000201000000000000000000011
     1222101     10000000000000000000000100011
     11201011111 11111111111100000000000111111
     10222022001 10001      100000000000111111
     1020002022111000111    11110000011111
     1002000000100020001    11111000111111
     1000020200000020001      111000111111
1111 1000000000100000201      11100011
1111 12220000201111111111     11100011
1022112200000021          11111110001111
1020111111011111          11111110001111
10001   10001             11000200000211
1101    10201             11201110001111
1000111110001             11221110001111
1020100210001             11221110001111
1000002210201             111111100011             1111111111111
1000100210201             1111111000111111111      1111111111111
1000111111011111                1000000000001      1111111111111
1020112000000001          11111120002111011011111111112000222211
1000110200000201          12020000000000021000000000010000000211
1000110020002001         120000000000000002111101110010000020011
1000010000000001          10000000000000000000000000010000000011
1020000200200001          12020000000022000000000000000000002001
1000010000000001          10000000000000000122200000002000000011
10001100200020011        120000000000000002111000001112022020211
1000110200000201         112000000000000021001100111102000000011
1000110000000201         111210100000112101011000011010000002011
1020112111011111            1 1100000000000011000110000120120101
1000011110001                  110000111111111100010001000000001
10001111000001                 1000001       1000110000000000001
1000120210001                  1100001       110201111111111111
1000002010201                  1000011       10001100100000101
10001200200001   1             1000001       11000100202220011
10201111100001111011111 1      1100011       11000002020002201
10200111002010100110120101     100001        10020100220020211
100000000000000001000002101    1100001       11011100101010101
1020002000200020000002000001   1000001       11111111111111111
100000000000000001000002101    1000011
100100100111110111101210111 111110000111111
1111111111010010010211111  1101010000111011
        1002001001001     10220010000000001
         101000001111     11000000000020001
          1 10111         11000010000000001
            1001          10000000000000001
            1021          11111100001111111
            1111          11000010001000011
                          10000200000200201
                          11000010001000011
                          11111100000110111
                          11000000000000011
                          10002000200022211
                          11200000200000011
11111111111111111111111111111111111111111111111111111111111111111111